+-------------------------------+-----------------------------------------------------------------------------------+
|                               |                                                                                   |
|             LOGO              |                                                                                   |
|                               |                                                                                   |
|                               |                                                                                   |
|                               |                                                                                   |
|                               |                                                                                   |
|                               |                                                                                   |
|                               |                                                                                   |
|          Hi, Drake     +------+                                                                                   |
|                        | Hide?|                                                                                   |
|                        | <----+                                                                                   |
|                        |      |                                                                                   |
+------------------------+------+                                                                                   |
|      Showing: Project Canary  |                                                                                   |
|   +--------------+            |                                                                                   |
|   |  More Dashes |            |                                                                                   |
|   +--------------+            |                                                                                   |
|                               |                             Some shit                                             |
|                               |                                                                                   |
|     Data Sources              |                                                                                   |
|                               |                                                                                   |
|  +------------------------+   |                                                                                   |
|  |                        |   |                                                                                   |
|  |  Foo                   |   |                                                                                   |
|  |  Bar                   |   |                                                                                   |
|  |  Baz                   |   |                                                                                   |
|  |  Bip                   |   |                                                                                   |
|  |  Bop                   |   |                                                                                   |
|  |  Shiggy                |   |                                                                                   |
|  |  Diggy                 |   |                                                                                   |
|  |  Do                    |   |                                                                                   |
|  |                        |   |                                                                                   |
|  |                        |   |                                                                                   |
|  |                        |   |                                                                                   |
|  |                        |   |                                                                                   |
|  |                        |   |                                                                                   |
|  +------------------------+   |                                                                                   |
|  +-----+ +-------+ +------+   |                                                                                   |
|  | plus| | minus | | gear |   |                                                                                   |
|  +-----+ +-------+ +------+   |                                                                                   |
+-------------------------------+-----------------------------------------------------------------------------------+

